111111
1P0001
100CC1
10E001
111111