11111111111
100000C0001
11111000C01
1000100P001
1E001000001
11111111111