111111
100PC1
1E000C
100000
111111