11111111111111111111111111111111
100000000000000000000000000000C1
10111111111111111111111110011111
1011C000000111C00000000000000001
1C111111100001111111111110111111
10000100000000000000000000000001
1111010000C000000000100000001001
11100100000000010000000010000001
11001CC0000010000010000100000101
11E01C0000000000000001000010P001
11111111111111111111111111111111